# # # # # # # # # # # # #
# . . . . . . . . . . . #
# . S . . . . . . . . . #
# . . . . . . . . . . . #
# . . . . . . . . . . . #
# . . . . . . . . . . . #
# . . . . . . . . . . . #
# . . . . . . . . . . . #
# . . . . . . . . . . . #
# . . . . . . . . . . . #
# . 10 . . . . . . . G . #
# . . . . . . . . . . . #
# # # # # # # # # # # # #
