# # # # # # # # # # # # #
# . . . . . . . . . . . #
# . S . . . . . . . 10 . #
# . . . . . . . . . . . #
# . . . . . . . . . . . #
# . . . . . . . . . . . #
# . . . . . . . . . . . #
# . . . . . . . . . . . #
# . . . . . . . . . . . #
# . . . . . . . . . . . #
# . 10 . . . . . . . G . #
# . . . . . . . . . . . #
# # # # # # # # # # # # #
