#   #   #   #   #   #   #   #   #   #   #   #   #
#   .   .   .   .   .   .   .   .   .   .   .   #
#   .   S   .   .   .   .   .   .   .   .   .   #
#   .   .   .   .   .   .   .   .   .   .   .   #
#   .   .   .   .   .   .   .   .   .   .   .   #
#   .   .   .   .   .   .   .   .   .   .   .   #
#   .   .   .   .   .   .   .   .   .   .   .   #
#   .   .   .   .   .   .   .   .   .   .   .   #
#   .   .   .   .   .   .   .   .   .   .   .   #
#   .   .   .   .   .   .   .   .   .   .   .   #
#   .   .   .   .   .   .   .   .   .   G   .   #
#   .   .   .   .   .   .   .   .   .   .   .   #
#   #   #   #   #   #   #   #   #   #   #   #   #