# # # # # # # # # # # # #
# . . . . . . -50 . . . . #
# . S . . . . -50 . . . . #
# . . . . . . . . . . . #
# . . . . . . -50 . . . . #
# . . . . . . -50 . . . . #
# -50 -50 . -50 -50 -50 -50 -50 -50 . -50 #
# . . . . . -50 . . . . . #
# . . . . . -50 . . . . . #
# . . . . . . . . . . . #
# . . . . . -50 . . . G . #
# . . . . . -50 . . . . . #
# # # # # # # # # # # # #
