#   #   #   #   #   #   #   #   #   #   #   #   #
#   .   .   .   .   .   .   #   .   .   .   .   #
#   .   S   .   .   .   .   #   .   .   .   .   #
#   .   .   .   .   .   .   .   .   .   .   .   #
#   .   .   .   .   .   .   #   .   .   .   .   #
#   .   .   .   .   .   .   #   .   .   .   .   #
#   #   #   .   #   #   #   #   #   #   .   #   #
#   .   .   .   .   .   #   .   .   .   .   .   #
#   .   .   .   .   .   #   .   .   .   .   .   #
#   .   .   .   .   .   #   .   .   .   .   .   #
#   .   .   .   .   .   .   .   .   .   G   .   #
#   .   .   .   .   .   #   .   .   .   .   .   #
#   #   #   #   #   #   #   #   #   #   #   #   #