# # # # # # # # # # # # # # # # # # # # # # # # # # # # # # #
# . . . . . . . . . # . . . . . . . . . # . . . . . . . . . #
# . S . . . . . . . # . . . . . . . . . # . . . . . . . . . #
# . . . . . . . . . # . . . . . . . . . # . . . . . . . . . #
# . . . . . . . . . # . . . . . . . . . # . . . . . . . . . #
# . . . . . . . . . # . . . . . . . . . # . . . . . . . . . #
# . . . . . . . . . . . . . . . . . . . . . . . . . . . . . #
# . . . . . . . . . # . . . . . . . . . # . . . . . . . . . #
# . . . . . . . . . # . . . . . . . . . # . . . . . . . . . #
# . . . . . . . . . # . . . . . . . . . # . . . . . . . . . #
# . . . . . . . . . # . . . . . . . . . # . . . . . . . . . #
# . . . . . . . . . # . . . . . . . . . # . . . . . . . . . #
# # # # # . # # # # # # # # # . # # # # # # # # # . # # # # #
# . . . . . . . . . # . . . . . . . . . # . . . . . . . . . #
# . . . . . . . . . # . . . . . . . . . # . . . . . . . . . #
# . . . . . . . . . # . . . . . . . . . # . . . . . . . . . #
# . . . . . . . . . # . . . . . . . . . # . . . . . . . . . #
# . . . . . . . . . # . . . . . . . . . # . . . . . . . . . #
# . . . . . . . . . . . . . . . . . . . . . . . . . . . . . #
# . . . . . . . . . # . . . . . . . . . # . . . . . . . . . #
# . . . . . . . . . # . . . . . . . . . # . . . . . . . . . #
# . . . . . . . . . # . . . . . . . . . # . . . . . . . . . #
# . . . . . . . . . # . . . . . . . . . # . . . . . . . G . #
# . . . . . . . . . # . . . . . . . . . # . . . . . . . . . #
# # # # # # # # # # # # # # # # # # # # # # # # # # # # # # #
