# # # # # # # # # # # # # # # # #
# . . . # . . . . . . . # . . . #
# . S . # . . . . . . . # . G . #
# . . . # . . . . . . . # . . . #
# . . . # . . . # . . . # . . . #
# . . . # . . . # . . . # . . . #
# . . . # . . . # . . . # . . . #
# . . . . . . . # . . . . . . . #
# . . . . . . . # . . . . . . . #
# . . . . . . . # . . . . . . . #
# # # # # # # # # # # # # # # # #