# # # # # # # # # # # # # # # # # # # # # # # # # # # # # # #
# . . . # . . . . . . . . . # . . . . . . . . . # . . . . . #
# . S . # . . . . . . . . . # . . . . . . . . . # . G . . . #
# . . . # . . . . . . . . . # . . . . . . . . . # . . . . . #
# . . . # . . . . # . . . . # . . . . # . . . . # . . . . . #
# . . . # . . . . # . . . . # . . . . # . . . . # . . . . . #
# . . . # . . . . # . . . . # . . . . # . . . . # . . . . . #
# . . . # . . . . # . . . . # . . . . # . . . . # . . . . . #
# . . . # . . . . # . . . . # . . . . # . . . . # . . . . . #
# . . . # . . . . # . . . . # . . . . # . . . . # . . . . . #
# . . . # . . . . # . . . . # . . . . # . . . . # . . . . . #
# . . . # . . . . # . . . . # . . . . # . . . . # . . . . . #
# . . . # . . . . # . . . . # . . . . # . . . . # . . . . . #
# . . . # . . . . # . . . . # . . . . # . . . . # . . . . . #
# . . . # . . . . # . . . . # . . . . # . . . . # . . . . . #
# . . . # . . . . # . . . . # . . . . # . . . . # . . . . . #
# . . . # . . . . # . . . . # . . . . # . . . . # . . . . . #
# . . . # . . . . # . . . . # . . . . # . . . . # . . . . . #
# . . . # . . . . # . . . . # . . . . # . . . . # . . . . . #
# . . . # . . . . # . . . . # . . . . # . . . . # . . . . . #
# . . . # . . . . # . . . . # . . . . # . . . . # . . . . . #
# . . . # . . . . # . . . . # . . . . # . . . . # . . . . . #
# . . . # . . . . # . . . . # . . . . # . . . . # . . . . . #
# . . . # . . . . # . . . . # . . . . # . . . . # . . . . . #
# . . . . . . . . # . . . . . . . . . # . . . . . . . . . . #
# . . . . . . . . # . . . . . . . . . # . . . . . . . . . . #
# . . . . . . . . # . . . . . . . . . # . . . . . . . . . . #
# # # # # # # # # # # # # # # # # # # # # # # # # # # # # # #
