# # # # # # # # # # # # #
# . . . . . . . . . . . #
# . S . . . . . . . . . #
# . . . . . . . . . . . #
# . . . . . . . . . . . #
# . . . . . . . . . . . #
# . . . . . . . . . . . #
# . . . . . . . . . . . #
# . . . . . . . . . . . #
# . . . . . . . . . . . #
# . . . . . . . . . G . #
# . . . . . . . . . . . #
# # # # # # # # # # # # #