# # # # # # # # # # # # #
# . . . . . . # . . . . #
# . S . . . . # . . . . #
# . . . . . . . . . . . #
# . . . . . . # . . . . #
# . . . . . . # . . . . #
# # # . # # # # # # . # #
# . . . . . # . . . . . #
# . . . . . # . . . . . #
# . . . . . . . . . . . #
# . . . . . # . . . G . #
# . . . . . # . . . . . #
# # # # # # # # # # # # #