#   #   #   #   #   #   #   #   #   #   #   #   #
#   .   .   .   .   .   .   .   .   .   .   .   #
#   .   .   .   .   .   .   .   .   .   .   .   #
#   .   .   .   .   .   .   .   .   .   .   .   #
#   .   .   .   .   .   .   .   .   .   .   .   #
#   .   .   .   .   .   .   .   .   .   .   .   #
#   .   .   #   #   #   #   #   #   #   .   .   #
#   .   .   #   .   #   .   #   .   #   .   .   #
#   .   .   #   .   .   .   #   .   #   .   .   #
#   .   S   #   .   #   .   #   .   #   G   .   #
#   .   .   .   .   #   .   .   .   #   .   .   #
#   .   .   #   .   #   .   #   .   .   .   .   #
#   #   #   #   #   #   #   #   #   #   #   #   #