#   #   #   #   #   #   #   #   #   #   #   #   #
#   .   .   .   .   .   .   #   .   .   .   .   #
#   .   S   .   .   .   .   #   .   .   .   .   #
#   .   .   .   .   .   .   .   .   .   .   .   #
#   .   .   .   .   .   .   #   .   .   .   .   #
#   .   .   .   .   .   .   #   .   .   .   .   #
#   #   #   .   #   #   #   #   #   #   .   #   #
#   .   .   .   .   .   #   .   .   .   .   .   #
#   .   #   .   #   .   #   .   .   .   .   .   #
#   .   .   .   .   .   #   .   .   .   .   .   #
#   .   #   .   #   .   .   .   .   .   G   .   #
#   .   .   .   .   .   #   .   .   .   .   .   #
#   #   #   #   #   #   #   #   #   #   #   #   #