# # # # # # # # # # # # # # # # # # # # # # # # #
# S S S S S S S # S S S S S S S # S S S S S S S #
# S G S S S S S # S S S S S S S # S S S S S S S #
# S S S S S S S # S S S S S S S # S S S S S S S #
# S S S S S S S S S S S S S S S S S S S S S S S #
# S S S S S S S # S S S S S S S # S S S S S S S #
# S S S S S S S # S S S S S S S # S G S S S S S #
# S S S S S S S # S S S S S S S # S S S S S S S #
# # # # S # # # # # # # S # # # # # # # S # # # #
# S S S S S S S # S S S S S S S # S S S S S S S #
# S S S S S S S # S S S S S S S # S S S S S S S #
# S S S S S S S # S S S S S S S # S S S S S S S #
# S S S S S S S S S S S G S S S S S S S S S S S #
# S S S S S S S # S S S S S S S # S S S S S S S #
# S S S S S S S # S S S S S S S # S S S S S S S #
# S S S S S S S # S S S S S S S # S S S S S S S #
# # # # S # # # # # # # S # # # # # # # S # # # #
# S S S S S S S # S S S S S S S # S S S S S S S #
# S S S S S S S # S S S S S S S # S S S S S S S #
# S S S S S S S # S S S S S S S # S S S S S S S #
# S S S G S S S S S S S S S S S S S S S S S S S #
# S S S S S S S # S S S S S S S # S S S S S S S #
# S S S S S S S # S S S S S S S # S S S S S G S #
# S S S S S S S # S S S S S S S # S S S S S S S #
# # # # # # # # # # # # # # # # # # # # # # # # #