#   #   #   #   #   #   #   #   #   #   #   #   #
#   .   .   .   #   .   .   .   #   .   .   .   #
#   .   .   .   #   .   .   .   #   .   .   .   #
#   #   .   #   #   #   .   #   #   #   .   #   #
#   .   .   .   .   .   .   .   .   .   .   .   #
#   .   .   .   .   .   .   .   .   .   .   .   #
#   .   .   .   .   .   .   .   .   .   .   .   #
#   .   .   .   .   .   .   .   .   .   .   .   #
#   .   .   .   .   .   .   .   .   .   .   .   #
#   .   .   .   .   .   .   .   .   .   .   .   #
#   .   S   .   .   .   .   .   .   .   G   .   #
#   .   .   .   .   .   .   .   .   .   .   .   #
#   #   #   #   #   #   #   #   #   #   #   #   #