# # # # # # # # # # # # # # # # # # # # #
# . . . . . . . . . # . . . . . . . . . #
# . S . . . . . . . # . . . . . . . . . #
# . . . . . . . . . # . . . . . . . . . #
# . . . . . . . . . # . . . . . . . . . #
# . . . . . . . . . # . . . . . . . . . #
# . . . . . . . . . . . . . . . . . . . #
# . . . . . . . . . # . . . . . . . . . #
# . . . . . . . . . # . . . . . . . . . #
# . . . . . . . . . # . . . . . . . . . #
# . . . . . . . . . # . . . . . . . G . #
# . . . . . . . . . # . . . . . . . . . #
# # # # # # # # # # # # # # # # # # # # #