# # # # # # # # #
# . . . # . . G #
# . . . . . . . #
# # . # # X . . #
# . . . # # . # #
# . . . # . . . #
# S . . . . . . #
# # # # # # # # #